
#Kill me....
Jeg vil heller ha deg - Sulele (not sure, men bitches..)
Shut up and dance - WALK THE MOON
Timber - Pitbull
Fireball . Pitbull
On the floor - Pitbull
Fatboy Slim - Funk Soul Brother
Foster the People - Pumped Up Kicks

Hung up - Madonna
Toxic - Britney
Naught Girl - Beyonce
Promiscuous - Nelly Furtado
Don't Cha - Pussycat Dolls
Dirrrty - Aguilera
Low - Flo Rida
Whistle - Flo Rida
Hey ya - Outkast (?)
Don't Worry - Madcon
Single Ladies - Beyonce
Can't Feel My face - the Weeknd
Thriller/Smooth Criminal/Billie Jean - Jackson
Sexyback - Timberlake
Fly by night - Broiler
Play my drum - Sandra Lyng
Only Girl in the World - Rihanna
Estelle - American Boy


Peanut Butter Jelly - Galantis
I love it - Icona Pop
Flytta på dej - Alina Devecerski
Levels - Nick Jonas
Pure Grinding - Avicii (Transition? Kanskje litt for ny)

#House-ish
How Deep is your love (Chris Lake remix)- Calvin Harris
Stardust - Music Sounds Better With You
Mojo - Lady (Går jøvlig bra med Stardust)
Robin S - Show Me Love
Eric Prydz - Call On Me
Ghosts n Stuff - mau5
Sugar - Schulz
Old thing Back - Matoma
2 AM - Matoma
Geranimo - Benny Banassi
Waiting for love - Autograf Mix
Habits - Chainsmokers mix

#Litt hardere
Bad - Guetta
Animals - Garrix
Albatraoz - AronChupa

#Bounce og full party
mASS
Selfie v2
Squats
Juicy Wiggle

